1111111111111111111111111111111111
100000000000000C00000C000000000011
1110010100100000101001000011111011
10100100101010100010010000P1EC0001
100000000C00C0000000000000111111C1
1111111111111111111111111111111111
